SSSSSSSSSSSSSSSSSSSS
SSSSSSSSSSSSSSSSSSSS
SWSWSWSWSWSWSWSWSWSW
SSSSSSSWSSSSWSSSSSSS
WSWSWSWSWSWSWSWSWSWS
SWSSSSSWSSSWSSSSWSSS
SWSWSWSWSWSWSWSWSWSW
SSWSSSWSSSSWSSSSWSSS
WSWSWSWSWSWSSSWWWSWS
SSSSSSSSSWSSSWSSSSSS
SWWWSWSWSWSWSSSWWSWW
SSSWSSSSWSSWSSWSSSSS
WSWSWSWSWSWWSSWSWSWS
SSSWSSSSWSWSSWSWSWSS
SWSWSSSWSWSWSWSWSWSW
SSSWSWSWWSSWSSWSSSSS
WSWSSSWSSSWSWSWSWSWS
SSWSWSSSSWSSWSSWSWSS
SWSWSWSWSWSWSWSWSWSW
SSSSSSSSSSSSSSWSSSSS