SWWWWWWWWWWWWWWWWWWW
SSSWWSSSSSSSSSSSSSWW
WWSWWSWWWWWWSWWWWSWW
WWSSSSWSSSWWSWSWWSWW
WWSWWSWWWSSSSWSWWSWW
WWSWWSWWWWWWWWSWWSWW
WWSWWSSSSSSSSSSWWSWW
WWSWWWWWWWWSWWWSWSWW
WWSWWSWWWWWSWWSSWSWW
WWSWWSSSSWWSWWSWWSWW
WWSWWSWWWWWSSSSWWSWW
WWSWWSWSSSWSWWWWWSWW
WWSWWSWSWSWSSWWSWSWW
WWSWWSWSWSSWSWWSWSSW
WWSSSSWSWWSWSWWSWWSW
WWSWWWWSSWSWSWWSWWSW
WWSWWWWWSWSWSSWSSSSW
WWSSSSSSSWSSWSSWWWWW
WWSWWWWWWWWSSWSSSWWW
WWSSSSSSSSSWSSWWSSSS
